xxxxxxxxxxxxxxxxxxxxxxxxxxxxxxxxxxxxxxxxxxxxxxxxxxxxxxxxxxxxx
x                                                           x
x                                                           x
x                                                           x
x       x  x                                                x
x                                                           x
x                                                           x
x                                                           x
x                                                           x
x                                                           x
x                 xxxxxxxxxxxx                              x
x       x  x      x          x                              x
x                 x  c       x     x                        x
x                 x          x                              x
x                 xxxxxxxxxxxx                              x
x                                                           x
x                       x                                   x
x                                                           x
x                   xxxxxxxxxxxx                            x
x                   x                                       x
x                   x                                       x
x                   x                                       x
x                                                           x
x                       x                                   x
x                                                           x
x                                                           x
x                                                           x
x                                                           x
x                                                           x
x                                                           x
xxxxxxxxxxxxxxxxxxxxxxxxxxxxxxxxxxxxxxxxxxxxxxxxxxxxxxxxxxxxx
