xxxxxxxxxxxxxxxxxxxxxxxxxxxxxxxxxxxxxxxxxxxxxxxxxxxxxxxxxxxxxxxxxxxxxxxxxxxxxxxxxxx
xxxxxxxxxxxxxxxxxxxxxxxxxxxxxxxxxxxxxxxxxxxxxxxxxxxxxxxxxxxxxxxxxxxxxxxxxxxxxxxxxxx
xx                                                                               xx
xx                                                                               xx
xx                                                                               xx
xx       x  x                                                                    xx
xx                                                                               xx
xx                                                                               xx
xx                                                                               xx
xx                                                                               xx
xx                                                                               xx
xx                 xxxxxxxxxxxx                                                  xx
xx       x  x      x          x                                                  xx
xx                 x  c       x     x                                            xx
xx                 x          x                                                  xx
xx                 xxxxxxxxxxxx                                                  xx
xx                                                                               xx
xx                       x                                                       xx
xx                                                                               xx
xx                   xxxxxxxxxxxx                                                xx
xx                   x                                                           xx
xx                   x                                                           xx
xx                   x                                                           xx
xx                                                                               xx
xx                                                                               xx
xx                                                                               xx
xx       x  x                                                                    xx
xx                                                                               xx
xx                                                                               xx
xx                                                                               xx
xx                                                                               xx
xx                                                                               xx
xx                   x                                                           xx
xx                                                                               xx
xx                                                                               xx
xx                                                                               xx
xx       x  x                                                                    xx
xx                                                                               xx
xx                                                                               xx
xx                                                                               xx
xx                                                                               xx
xx                   x                                                           xx
xx                                                                               xx
xx                                                                               xx
xx                                                                               xx
xx       x  x                                                                    xx
xx                                                                               xx
xx                                                                               xx
xx                                                                               xx
xx                 xxxxxxxxxxxx                                                  xx
xx       x  x      x          x                                                  xx
xx                 x  c       x     x                                            xx
xx                 x          x                                                  xx
xx                 xxxxxxxxxxxx                                                  xx
xx                                                                               xx
xx                       x                                                       xx
xx                                                                               xx
xx                   xxxxxxxxxxxx                                                xx
xx                   x                                                           xx
xx                   x                                                           xx
xx                   x                                                           xx
xxxxxxxxxxxxxxxxxxxxxxxxxxxxxxxxxxxxxxxxxxxxxxxxxxxxxxxxxxxxxxxxxxxxxxxxxxxxxxxxxxx
xxxxxxxxxxxxxxxxxxxxxxxxxxxxxxxxxxxxxxxxxxxxxxxxxxxxxxxxxxxxxxxxxxxxxxxxxxxxxxxxxxx
