xxxxxxxxxxxxxxxxxxxxxxxxxxxxxxxxxxxxxxxxxxxxxxxxxxxxxxxxxx
xp   . . . . . . . . . . . . . . . . . . . . . . . . .   x
x                                                        x
x    . . . . . . . . . . . . . . . o . . . . . . . . .   x
x  x                                                     x
x  x                          c                          x
x  x                                                     x
x  x                                                     x
x  x                                                     x
x  x                                                     x
x  x                                                     x
x  x              xxxxxxxxxxxx                           x
x                 x          x                           x
x                 x  c       x     x                     x
x  x              x          x                           x
x  x              xxxxxxxxxxxx                           x
x  x                                                     x
x  x                    x                                x
x  x                                        o            x
x  x                xxxxxxxxxxxx                         x
x  x                x                                    x
x  x                x                                    x
x                                                        x
xxxxxxxxxxxxxxxxxxxxxxxxxxxxxxxxxxxxxxxxxxxxxxxxxxxxxxxxxx
